EA ./pics/bricks/east.xpm
WE ./pics/bricks/west.xpm
NO ./pics/bricks/north.xpm
SO ./pics/bricks/south.xpm


C 50,150,200
F 105, 105, 105

1111111111111111111
1000000000000010001
100E000000000010001
1000000000000010001
1111000000000000001
1000000010000010001
1000000010000010001
1111111110000000001
1000000000000000001
1000000000000000001
1111111111111111111
