NO ./pics/newyear/north.xpm

SO ./pics/newyear/south.xpm
WE ./pics/newyear/west.xpm
EA ./pics/newyear/east.xpm
F 169, 169, 169
C 200, 220, 255


111111111111111111111
100100000000000100001
101111101111000100001
100000100000000110111
100000100000000000001
1100E0000000001111111
100000000000000000001
111111111111111111111
